.......................................................................................................
.......................................................................................................
.......................................................x...............................................
.......................................................................................................
.......................................................................................................
.....................................x..x.............."...............................................
....................................."""""".............................................................
.................................................."....................................................
.....""""""".............................................................xx............................
..................x...........""""............"...............#........................................
................""".........................................####.......................................
................x........................................########....."".............................x.
..............########....######............#.##.##.##.##########.......############.....####...###.##.
